#################################
##  ####### # ## ####  ##########
##                ###     A    ##                     
##  ### ######    ### ######## ##
##  ###     ###           #    ##
##  ####### ### # #    ##    # ##
B               # #   ##  #  # ##
################################# 