#################################
#####     #    ##    # ###   ####
##    ##### ## #  ####     #   ##
## ######## ## # ##### ####### ##
##               ##      B    ###                    
## # ## ######## #### ######## ##
## #  #     ###           #    ##
## ######## ### # #    ##    # ##
#A              # #   ##  #  # ##
################################# 